Mammals
This mammal is the most common wool producer|sheep
This mammal has the longest neck|giraffe
These primates have no tail|apes
This mammallian order has the most specied|rodent
This mammal is man's best friend|dog

Word origins
<em>Sabotage<em> comes from these French shoes|sabot
This word means without breath in <b>Greek</b>|apnea
This word for killing someone by pushing them out a window comes from the French word for window|defenestration
This eponym describes a particular type of early photograph|daguerreotype
This is the Latin prefix for 'five'|pente
#This is autopsy word comes from two words meaning 'cut' and 'apart' (not two!)|dissect

Sounds Like a Letter of the Alphabet
Can follow "bumble"|b
French "mer"|c
Part of a needle|i
Blue bird|j
Plural "is"|r

Found in "France"
Vied for office|ran
Top pilot|ace
Dog sound|arf
Used for food storage|can
Marathon|race

Cities in Pennsylvania
Home to Old Economy Village|Ambridge
Lost then regained its "h"|Pittsburgh
Largest city|Philadelphia
Capital|Harrisburg
Largest port|Erie

Medical prefixes
Kidney|nephro or renal
Liver|hepato
Brain|cephalo
Eye|Ophtho
Heart|Cardio




Famous Lynns
Osher director|Decker
Hamilton composer|Manuel Miranda
Coal miner's daughter|Loretta
Actress Vanessa's sister|Redgrave
Superbowl winning wide receiver|Swann

Cartoon Characters
Quick Draw|McGraw
Opera singing rodent|Mighty Mouse
Struttering Rooster|Foghorn Leghorn
Amorous skunk|Pepe LePeu
Yogi Bear's sidekick|Booboo

Legal Dramas by Character
Harvey Specter|Suits
Mickey Haller|The Lincoln Lawyer
Alicia Florrick|The Good Wife
Della Street|Perry Mason
Annalise Keating|How to Get Away with Murder

Woody Allen Movies
Wakes up in the Future|Sleeper
1977 comedy with four Oscars|Annie Hall
Starring Mia Farrow, Barbara Hershey and Diane Wiest|Hannah and her Sisters
1985 Fantasy Romantic Comedy about a vacation to Egypt|Purple Rose of Cairo
1984 Flick where a hapless talent agent gets involved with the mob|Broadway Danny Rose

Russian Authors by Novel
Crime and Punishment|Dostoevsky
Doctor Zhivago|Pasternak
War and Peace|Tolstoy
Eugene Onegin|Pushkin
Dean Souls|Gogol

Apple Varieties without vowels
Hnycrsp|Honeycrisp
Gl|Gala
Gldn Dlcs|Golden Delicious
Mcntsh|McInsosh
FJ|Fuji


Crafts
In weaving, this is perpendicular to the warp|weft
